___w________________
_________w__________
__o___________o_____
_1__________________
_________w__________
___w___________p____
_2__________________
____________________
____________________
____w_______________