___www______________
_o_______w__________
__o______w____o_____
_____p______________
_________w__________
___www____p____p____
_____o______________
w_____________pp____
____o___p___________
____wwwwww__________