wwwwwwwwwwwwwwwwwwww
w________w_________w
w_o___________o____w
w1_________________w
w________w_________w
w__w___________p___w
w2_________________w
w__________________w
w__________________w
wwwwwwwwwwwwwwwwwwww