___www______________
_________w__________
__o______w____o_____
_1___p______________
_________w__________
___www____p____p____
_2___o______________
w_____________pp____
____o___p___________
____wwwwww__________