wwwwwwwwwwwwwwwwwwww
w________w_________w
w_o___________o____w
w1_________________w
w________w_________w
w__w___________p___w
w2_w__ww__www__wwww_
w___________________
w__________________w
wwwwwwwwwwwwwwwwwwww